[
  [
      "         ",
      "         ",
      "    =    ",
      "       o ",
      "     !xxx",
      " @       ",
      "xxx!     ",
      "         "
    ],
    [
      "      v  ",
      "    v    ",
      "  v      ",
      "        o",
      "        x",
      "@   x    ",
      "x        ",
      "         "
  ]
]